11111111111111111111
1P000C111C000111C001
1001110E111000111001
10110001111110000C11
10000111111C00000001
1100011C011110000111
11101111001110000001
111000000011101100E1
1C0001111C1100000011
11110001111100110001
11111011111110110001
11C000000000000100C1
11111111111111111111