11111111111111111111
1P000C111C00E111CC01
1001110E111C00111001
1011C001111110000C11
100G00G0G1C00EC00011
1100011C011110000111
11101111001110000001
110000C1100000111001
111C000000111011C0E1
11111111111111111111