11111111111111111111
1P000C111C000111CC01
1001110E111C001110E1
1011C0011111100G0C11
10010000G11C00000011
1100011C011110000111
11101111001110000G01
110000C1100000111001
111C000000111011C0E1
11111111111111111111