11111111111111111111
1P000C111C000111CC01
10000011000000110001
1000G001110000000001
10011100111C001110E1
100011000E10000E0011
10000001111000000011
1011C001111110000C11
10010000011C00000011
100000E0011000000011
1100011C011110000111
11101111001110000001
11000000001000000111
110000C1100000100001
11000000000011000001
111C000000111011C0E1
11111111111111111111