1111111111111111111111111111111111111
1E0000000000000C00000C000000000000001
1010010100100000101001000101000000001
1010010010101010001001000101000000001
1P0000000C00C000000000000000C01100001
1000010000101010001001000101000000C01
1000010000101010001001000101000001001
1000010000101010001001000101000010001
1000010000101010001001000101000110011
1000010000101010001001000101001100011
1000010000101010001001000101000000001
1C00100000010100010010001010000000011
1001110010001010001001000101000000001
1000010010001010001001000101000000001
1000010010001010001001000101000000001
1111111111111111111111111111111111111