11111111111111111111
1P000C111C000111CC01
100000110000G0110001
1000G001110000000001
10011100111C001110E1
100011000E10000E0011
10000001111000000011
1G11C0011111100G0C11
10010000G10C00000011
110G0000000000000111
111C000000111011C0E1
11111111111111111111